1111111111111111
1E00000000000001
1010001P00000001
1010000000101001
100000000C00C011
1111111111111111