1111111111111111
1E00000P00000001
1010001000000001
1010000000101001
100000000C00C011
1111111111111111