1111111111111111
1E00C00PF000C001
1010001000000F01
1010000000101001
1000C000FC00C011
1111111111111111