1111111111111111
1E00CF0PF000C0F1
1010001000000001
10100000C0101001
1000C0000C00C011
1111111111111111