1111111111111111
1E00C00PF000C0F1
1010001000000001
1010000000101001
1000C0000C00C011
1111111111111111