1111111111111
1001000000001
1PC0011111001
100000E000001
1111111111111