1111111111111111111111111111111111111111111
1000000000000000000000000000000000000000001
10000000000000011111110000C1111110111111111
100E0000000011111111000000C1111000111111111
10000000001111111P00000000C1000000111111111
1000000111111110000000000000000000111111101
1000011111110000000000000000000111111110001
1011111111000000000000000000011111110000001
11111111CCCCCCCCCCCCCCC000C1111111000000001
11111111111111111111111000C1111111000001111
11111111111111111111111000C1111111000111111
10000000000000011111111000C1111111111111111
1000000000000001111111100000000000000000001
1000000000000001111111100000000000000000001
1111111111111111111111111111111111111111111