0000000000000
10010000000C1
1000011111001
1P0011E000001
0000000000000